To be out of your comfort zone - Вийти із зони комфорту ;; Try something new and get out of your comfort zone. ; Спробуй щось нове й вийди із зони комфорту. ;; Moving abroad pushed me out of my comfort zone. ; Переїзд за кордон змусив мене вийти із зони комфорту.
To be over the moon - Бути на сьомому небі від щастя ;; She was over the moon about her results. ; Вона була на сьомому небі від щастя через свої результати. ;; I was over the moon when I got the job. ; Я був на сьомому небі від щастя, коли отримав цю роботу.
To be under the weather - Почуватися погано ;; I’m feeling under the weather today. ; Я сьогодні почуваюсь недобре. ;; He’s under the weather, so he stayed home. ; Він погано почувається, тому залишився вдома.
To freak out - Панікувати ;; I freaked out when I saw the spider. ; Я злякався, коли побачив павука. ;; Don’t freak out, everything is fine. ; Не панікуй, усе добре.
To keep your cool - Зберігати спокій ;; Try to keep your cool in stressful situations. ; Намагайся зберігати спокій у стресових ситуаціях. ;; He kept his cool during the interview. ; Він зберіг спокій під час співбесіди.
To make up your mind - Прийняти рішення ;; Have you made up your mind yet? ; Ти вже прийняв рішення? ;; I can’t make up my mind about dinner. ; Я не можу вирішити, що їсти на вечерю.
As far as I know - Наскільки я знаю ;; As far as I know, she’s still abroad. ; Наскільки я знаю, вона досі за кордоном. ;; As far as I know, the event starts at 6. ; Наскільки я знаю, подія починається о 6.
I couldn’t agree more - Повністю згоден ;; This movie is amazing – I couldn’t agree more. ; Цей фільм чудовий – я повністю згоден. ;; You’re right about that – I couldn’t agree more. ; Ти правий щодо цього – я повністю згоден.
That’s a good point - Це хороша думка ;; That’s a good point, I hadn’t thought of that. ; Це хороша думка, я про це не подумав. ;; You raised a good point about safety. ; Ти підняв важливу думку про безпеку.
On the other hand - З іншого боку ;; It’s expensive, but on the other hand, it’s high quality. ; Це дорого, але з іншого боку, якісно. ;; I want to rest, but on the other hand, I need to work. ; Я хочу відпочити, але з іншого боку, треба працювати.
If I were you - Якби я був на твоєму місці ;; If I were you, I’d take the job. ; Якби я був на твоєму місці, я б погодився на цю роботу. ;; If I were you, I’d talk to her. ; Якби я був на твоєму місці, я б поговорив з нею.
At the end of the day - Зрештою ;; At the end of the day, we all want to be happy. ; Зрештою, ми всі хочемо бути щасливими. ;; At the end of the day, it’s your decision. ; Зрештою, це твоє рішення.
By the way - До речі ;; By the way, have you seen my keys? ; До речі, ти не бачив мої ключі? ;; By the way, I met Anna yesterday. ; До речі, я вчора зустрів Анну.
For the time being - Поки що ;; We’ll stay here for the time being. ; Ми залишимось тут поки що. ;; For the time being, let’s focus on the basics. ; Поки що давай зосередимось на основах.
It’s up to you - Тобі вирішувати ;; What movie should we watch? It’s up to you. ; Який фільм подивимось? Тобі вирішувати. ;; It’s up to you to make the final choice. ; Остаточне рішення за тобою.
Keep in mind - Мати на увазі ;; Keep in mind that this is just a test. ; Майте на увазі, що це лише тест. ;; Keep in mind that she’s new here. ; Майте на увазі, що вона тут новенька.
To be ahead of the curve - Бути на крок попереду ;; Our company is ahead of the curve in technology. ; Наша компанія на крок попереду в технологіях. ;; He always tries to stay ahead of the curve. ; Він завжди намагається бути на крок попереду.
To multitask - Робити кілька справ одночасно ;; She can multitask very well. ; Вона добре справляється з кількома справами одночасно. ;; Multitasking helps me save time. ; Багатозадачність допомагає мені економити час.
To take responsibility - Брати відповідальність ;; You must take responsibility for your actions. ; Ти повинен брати відповідальність за свої дії. ;; He took full responsibility for the mistake. ; Він повністю взяв на себе відповідальність за помилку.
To meet the deadline - Вкластися в дедлайн ;; We need to meet the deadline this week. ; Ми повинні вкластися в дедлайн цього тижня. ;; She always meets her deadlines. ; Вона завжди встигає до дедлайнів.
To brainstorm - Генерувати ідеї ;; Let’s brainstorm some ideas for the project. ; Давайте згенеруємо ідеї для проєкту. ;; The team spent an hour brainstorming. ; Команда провела годину, генеруючи ідеї.
To get straight to the point - Перейти прямо до суті ;; Let’s get straight to the point. ; Давайте перейдемо прямо до суті. ;; He always gets straight to the point. ; Він завжди говорить прямо.
To beat around the bush - Говорити натяками, уникати теми ;; Stop beating around the bush and answer me. ; Перестань говорити натяками й відповідай мені. ;; She tends to beat around the bush when she’s nervous. ; Вона має звичку говорити натяками, коли нервує.
To make a long story short - Якщо коротко ;; To make a long story short, we missed the train. ; Якщо коротко, ми запізнилися на потяг. ;; To make a long story short, everything went well. ; Якщо коротко, все пройшло добре.
To get the hang of it - Освоїти щось, почати розуміти ;; You’ll get the hang of it soon. ; Ти швидко освоїш це. ;; It took me a while to get the hang of this tool. ; Мені знадобився час, щоб освоїти цей інструмент.
To run into someone - Випадково зустріти когось ;; I ran into Tom at the mall. ; Я випадково зустрів Тома в торговому центрі. ;; We ran into our teacher at the café. ; Ми випадково зустріли нашого вчителя в кафе.
To book a ticket - Забронювати квиток ;; I booked a ticket to Paris. ; Я забронював квиток до Парижа. ;; You should book your ticket in advance. ; Тобі слід забронювати квиток заздалегідь.
To check in / check out - Заселитися / виселитися ;; We’ll check in at noon. ; Ми заселимося опівдні. ;; Please check out before 11 a.m. ; Будь ласка, виселіться до 11 ранку.
To get lost - Заблукати ;; We got lost in the city. ; Ми заблукали в місті. ;; I always get lost in new places. ; Я завжди гублюся в нових місцях.
To go sightseeing - Оглядати визначні місця ;; We went sightseeing in Rome. ; Ми оглядали визначні місця Риму. ;; I love going sightseeing when I travel. ; Я люблю оглядати пам’ятки, коли подорожую.